1111111111111111111
1AMR000000000000001
1111111100000000001
1AP000000100R0000E1
1111111111111111111