00000000000000000
00000000000000000
00000000000000000
00000000000000000
0P000000000010000
11111111111111111