111111111111111111111111
100000000000000000R00AM1
100000111000000101111111
100100000011111000000001
1MP000000100R000R00R00E1
111111111111111111111111