1111111111111
1000000000001
1PAAAA0000001
1111111111101
1000000000001
1000000000001
1000000000001
1000000000001
1000000000001
1000000000001111111111111111111111
1RR0R0R0RR0RR0R0R0RR0R0R00R0RR0RR1
1111111111111111111111111111111111