1111111111111111111
1000000000000000001
1111111100000000001
10P0000001000000001
1111111111111111111