111111111111111111111111111
100000R00000000000000000001
1E0R11110000R0000R000000RA1
111110001001111011110000111
100000000000000000000100001
100001110000011111001110011
10P0111110R01AM0R001M0R0111
111111111111111111111111111