1111111111111111111
100R000000000000001
1111111100000000001
1AP000000100R000001
1111111111111111111