111111111111111111111111
100000000000000000R000E1
100000111000000101111111
100100000011111000000001
1MP000000100R000R00R0001
111111111111111111111111